b b b b b b b b b b b b j k b b b b b b b b b b b b
b b g g g g g g g g g g r r g g g g g g g g g g b b
b b g g g g g g g g g g r r g g g g g g g g g g b b
b b g g r r r r r r r r r r r r r r r r r r g g b b
b b g g r r r r r r r r r r r r r r r r r r g g b b
b b g g r r r r r r r r r r r r r r r r r r g g b b
b b g g r r r r r r r r r r r r r r r r r r g g b b
b b g g r r r r r r r r r r r r r r r r r r g g b b
b b g g r r r r r r r r r r r r r r r r r r g g b b
b b g g r r r r r r r r r r r r r r r r r r g g b b
b b g g r r r r r r r r r r r r r r r r r r g g b b
b b g g r r r r r r r r r r r r r r r r r r g g b b
b b g g r r r r r r r r r r r r r r r r r r g g b b
b b g g r r r r r r r r r r r r r r r r r r g g b b
b b g g r r r r r r r r r r r r r r r r r r g g b b
b b g g r r r r r r r r r r r r r r r r r r g g b b
b b g g r r r r r r r r r r r r r r r r r r g g b b
b b g g r r r r r r r r r r r r r r r r r r g g b b
b b g g r r r r r r r r r r r r r r r r r r g g b b
b b g g r r r r r r r r r r r r r r r r r r g g b b
b b g g r r r r r r r r r r r r r r r r r r g g b b
b b g g r r r r r r r r r r r r r r r r r r g g b b
b b g g r r r r r r r r r r r r r r r r r r g g b b
b b g g g g g g g g g g r r g g g g g g g g g g b b
b b g g g g g g g g g g r r g g g g g g g g g g b b
b b b b b b b b b b b b r r b b b b b b b b b b b b