b b b b b b b b r b b b b
b f f f f r r r r r f r b
b f r r f r r r r f f r b
b f f f r r r r f r f r b
b f r r f r r f f f f f b
b f r r f r r r r r f r b
b f f f f r r r r r f r b
b r r r r r r r r r r r b
b r r r r r r r r r r r b
b r r r r r r r r r r r b
b r r r r r r r r r r r b
b r r r r r r r r r r r b
b b b b b b b b r b b b b