b b b b b b b b b b b b r r b b b b b b b b b b b b
b b r r r r r r r r r r r r r r r r r b b b b b b b
b b r g b b r r r r b b r r r r r r r b b b b b b b
b b r g r r b r r b r b r r r r r r r b b b b b b b
b b r g r r b r b r r b r r r r r r r b b b b b b b
b b r g b b r r b b b b b r r r r r r r r r r r b b
b b r g r r b r r r r b r r r r r r r r r r r r b b
b b r g r r g r r r r b r r r r r r r r r r r r b b
b b r g g g r r r r r b r r r r r r r r r r r r b b
b b r r r r r r r r r r r r r r r r r r r r r r b b
b b r r r r r r r r r r r r r r r r r r r r r r b b
b b r r r r r r r r r r r r r r r r r r r r r r b b
b b r r r r r r r r r r r r r r r r r r r r r r b b
b b r r r r r r r r r r r r r r r r r r r r r r b b
b b r r r r r r r r r r r r r r r r r r r r r r b b
b b r r r r r r r r r r r r r r r r r r r r r r b b
b b r r r r r r r r r r r r r r r r r r r r r r b b
b b r r r r r r r r r r r r r r r r r r r r r r b b
b b r r r r r r r r r r r r r r r r r r r r r r b b
b b b r r r r r r r r r r r r r r r r r r r r r b b
b b r r r r r r r r r r r r r r r r r r r r r r b b
b b b b b b b r r r r r r r r r r r r r r r r r b b
b b b b b b b r r r r r r r r r r r r r r r r r b b
b b b b b b b r r r r r r r r r r r r r r r r r b b
b b b b b b b r r r r r r r r r r r r r r r r r b b
b b b b b b b b b b b b r r b b b b b b b b b b b b