b b b b b b b b r b b b b
b b r r r r r r r r r b b
b b r r r r r r r r r b b
b b r r r r r r r r r b b
b b r r r r r r r r r b b
b b r r f r f r r r r b b
b b r r r r r r r r r b b
b b r f r r r f r r r b b
b b r r f f f r r r r b b
b b r r r r r r r r r b b
b b r r r r r r r r r b b
b b r r r r r r r r r b b
b b b b b b b b r b b b b