b b b b b b b b b b b b j k b b b b b b b b b b b b
b b b b b b b b b b b b r r b b b b b b b b b b b b
b b b b b b b b b b b b r r b b b b b b b b b b b b
b b b b b b b b b b b b r r b b b b b b b b b b b b
b b b b b b b b b b b b r r b b b b b b b b b b b b
b b b b b b b b b b b b r r b b b b b b b b b b b b
b b b b b b b b b b b b r r b b b b b b b b b b b b
b b b b b b b b b b b b r r b b b b b b b b b b b b
b b b b b b b b b b b b r r b b b b b b b b b b b b
b b b b b b b b b b b b r r b b b b b b b b b b b b
b b b b b b b b b b b b r r b b b b b b b b b b b b
b r r r r r r r r r r r r r r r r r r r r r r r r b
b r r r r r r r r r r r r r r r r r r r r r r r r b
b b b b b b b b b b b b r r b b b b b b b b b b b b
b b b b b b b b b b b b r r b b b b b b b b b b b b
b b b b b b b b b b b b r r b b b b b b b b b b b b
b b b b b b b b b b b b r r b b b b b b b b b b b b
b b b b b b b b b b b b r r b b b b b b b b b b b b
b b b b b b b b b b b b r r b b b b b b b b b b b b
b b b b b b b b b b b b r r b b b b b b b b b b b b
b b b b b b b b b b b b r r b b b b b b b b b b b b
b b b b b b b b b b b b r r b b b b b b b b b b b b
b b b b b b b b b b b b r r b b b b b b b b b b b b
b b b b b b b b b b b b r r b b b b b b b b b b b b
b b b b b b b b b b b b r r b b b b b b b b b b b b
b b b b b b b b b b b b r r b b b b b b b b b b b b