b b b b b b b b r b b b b
b b b r r r r f r f b b b
b b r r r r r f f f r b b
b b r r r r r r r r r b b
b b r r r r r r r r r b b
b b r r r r r r r r r b b
b b r r r r r r r r r b b
b b r r r r r r r r r b b
b b r r r r r r r r r b b
b b r r r r r r r r r b b
b b r r r r r r r r r b b
b b b r r r r r r r b b b
b b b b b b b b r b b b b