b b b b b b b b b b b b b b b b b b b b b b b b b b
b b b g b r r r r r r r r r r r r r r r r b g b b b
b b g b b r r r r r r r r r r r r r r r r b b g b b
b b b b b r r r r r r r r r r r r r r r r b b b b b
b b r r r r r r r r r r r r r r r r r r r r r r b b
b b r r r r r r r r r r r r r r r r r r r r r r b b
b b r r r r r r r r r r r r r r r r r r r r r r b b
b b r r r r r r r r r r r r r r r r r r r r r r b b
b b r r r r r r r r r r r r r r r r r r r r r r b b
b b r r r r r r r r r r r r r r r r r r r r r r b b
b b r r r r r r r r r r r r r r r r r r r r r r b b
b b r r r r r r r r r r r r r r r r r r r r r r b b
b b r r r r r r r r r r r r r r r r r r r r r r b b
b b r r r r r r r r r r r r r r r r r r r r r r b b
b b r r r r r r r r r r r r r r r r r r r r r r b b
b b r r r r r r r r r r r r r r r r r r r r r r b b
b b r r r r r r r r r r r r r r r r r r r r r r b b
b b r r r r r r r r r r r r r r r r r r r r r r b b
b b r r r r r r r r r r r r r r r r r r r r r r b b
b b r r r r r r r r r r r r r r r r r r r r r r b b
b b r r r r r r r r r r r r r r r r r r r r r r b b
b b r r r r r r r r r r r r r r r r r r r r r r b b
b b r r r r r r r r r r r r r r r r r r r r r r b b
b b r r r r r r r r r r r r r r r r r r r r r r b b
b b r r r r r r r r r r r r r r r r r r r r r r b b
b b b b b b b b b b b b r r b b b b b b b b b b b b